"filename", "language", "Java", "ANTLR", "comment", "blank", "total"
"c:\Users\class\Cyclone\src\AlphabetException.class", "Java", 8, 0, 0, 0, 8
"c:\Users\class\Cyclone\src\AlphabetException.java", "Java", 9, 0, 0, 5, 14
"c:\Users\class\Cyclone\src\Cyclone.class", "Java", 87, 0, 0, 0, 87
"c:\Users\class\Cyclone\src\Cyclone.java", "Java", 158, 0, 29, 47, 234
"c:\Users\class\Cyclone\src\DFA.class", "Java", 65, 0, 0, 0, 65
"c:\Users\class\Cyclone\src\DFA.java", "Java", 139, 0, 18, 29, 186
"c:\Users\class\Cyclone\src\FSM.class", "Java", 5, 0, 0, 0, 5
"c:\Users\class\Cyclone\src\FSM.java", "Java", 4, 0, 0, 2, 6
"c:\Users\class\Cyclone\src\State.class", "Java", 13, 0, 0, 0, 13
"c:\Users\class\Cyclone\src\State.java", "Java", 7, 0, 1, 4, 12
"c:\Users\class\Cyclone\src\TestCyclone.class", "Java", 64, 0, 0, 0, 64
"c:\Users\class\Cyclone\src\TestCyclone.java", "Java", 127, 0, 23, 37, 187
"c:\Users\class\Cyclone\src\org\nuim\cyclone\compiler\MachineCompiler.java", "Java", 77, 0, 0, 16, 93
"c:\Users\class\Cyclone\src\org\nuim\cyclone\model\Element.java", "Java", 5, 0, 0, 1, 6
"c:\Users\class\Cyclone\src\org\nuim\cyclone\model\ErrorLog.java", "Java", 12, 0, 4, 5, 21
"c:\Users\class\Cyclone\src\org\nuim\cyclone\model\Expression.java", "Java", 25, 0, 0, 7, 32
"c:\Users\class\Cyclone\src\org\nuim\cyclone\model\GlobalVariables.java", "Java", 23, 0, 1, 3, 27
"c:\Users\class\Cyclone\src\org\nuim\cyclone\model\IdentExpr.java", "Java", 10, 0, 3, 3, 16
"c:\Users\class\Cyclone\src\org\nuim\cyclone\model\Machine.java", "Java", 37, 0, 0, 11, 48
"c:\Users\class\Cyclone\src\org\nuim\cyclone\model\NamedElement.java", "Java", 11, 0, 0, 1, 12
"c:\Users\class\Cyclone\src\org\nuim\cyclone\model\OpExpr.java", "Java", 57, 0, 3, 13, 73
"c:\Users\class\Cyclone\src\org\nuim\cyclone\model\State.java", "Java", 47, 0, 1, 11, 59
"c:\Users\class\Cyclone\src\org\nuim\cyclone\model\StateModifier.java", "Java", 7, 0, 0, 2, 9
"c:\Users\class\Cyclone\src\org\nuim\cyclone\model\TypeChecker.java", "Java", 32, 0, 3, 8, 43
"c:\Users\class\Cyclone\src\org\nuim\cyclone\model\Variable.java", "Java", 41, 0, 0, 11, 52
"c:\Users\class\Cyclone\src\org\nuim\cyclone\model\operation\ArithOperator.java", "Java", 182, 0, 36, 47, 265
"c:\Users\class\Cyclone\src\org\nuim\cyclone\model\operation\BoolOperator.java", "Java", 89, 0, 18, 24, 131
"c:\Users\class\Cyclone\src\org\nuim\cyclone\model\operation\Operator.java", "Java", 79, 0, 12, 17, 108
"c:\Users\class\Cyclone\src\org\nuim\cyclone\model\operation\OperatorNotDefinedException.java", "Java", 16, 0, 0, 5, 21
"c:\Users\class\Cyclone\src\org\nuim\cyclone\model\operation\RelationalOperator.java", "Java", 137, 0, 24, 36, 197
"c:\Users\class\Cyclone\src\org\nuim\cyclone\model\operation\StdOperator.java", "Java", 75, 0, 16, 25, 116
"c:\Users\class\Cyclone\src\org\nuim\cyclone\model\operation\TypeDef.java", "Java", 34, 0, 3, 6, 43
"c:\Users\class\Cyclone\src\org\nuim\cyclone\model\operation\TypeException.java", "Java", 26, 0, 0, 8, 34
"c:\Users\class\Cyclone\src\org\nuim\cyclone\model\type\BoolType.java", "Java", 10, 0, 0, 4, 14
"c:\Users\class\Cyclone\src\org\nuim\cyclone\model\type\CharType.java", "Java", 10, 0, 0, 5, 15
"c:\Users\class\Cyclone\src\org\nuim\cyclone\model\type\EnumType.java", "Java", 24, 0, 0, 5, 29
"c:\Users\class\Cyclone\src\org\nuim\cyclone\model\type\IntType.java", "Java", 10, 0, 0, 4, 14
"c:\Users\class\Cyclone\src\org\nuim\cyclone\model\type\NonPrimitiveType.java", "Java", 6, 0, 0, 2, 8
"c:\Users\class\Cyclone\src\org\nuim\cyclone\model\type\ObjType.java", "Java", 3, 0, 3, 2, 8
"c:\Users\class\Cyclone\src\org\nuim\cyclone\model\type\PrimitiveType.java", "Java", 6, 0, 0, 2, 8
"c:\Users\class\Cyclone\src\org\nuim\cyclone\model\type\RealType.java", "Java", 10, 0, 0, 4, 14
"c:\Users\class\Cyclone\src\org\nuim\cyclone\model\type\StringType.java", "Java", 10, 0, 0, 5, 15
"c:\Users\class\Cyclone\src\org\nuim\cyclone\model\type\Type.java", "Java", 17, 0, 5, 3, 25
"c:\Users\class\Cyclone\src\org\nuim\cyclone\model\type\TypeElement.java", "Java", 5, 0, 1, 1, 7
"c:\Users\class\Cyclone\src\org\nuim\cyclone\model\type\VoidType.java", "Java", 10, 0, 0, 4, 14
"c:\Users\class\Cyclone\src\org\nuim\cyclone\model\value\BoolValue.java", "Java", 14, 0, 0, 5, 19
"c:\Users\class\Cyclone\src\org\nuim\cyclone\model\value\CharValue.java", "Java", 14, 0, 0, 7, 21
"c:\Users\class\Cyclone\src\org\nuim\cyclone\model\value\EnumValue.java", "Java", 18, 0, 0, 5, 23
"c:\Users\class\Cyclone\src\org\nuim\cyclone\model\value\IntValue.java", "Java", 14, 0, 0, 6, 20
"c:\Users\class\Cyclone\src\org\nuim\cyclone\model\value\RealValue.java", "Java", 14, 0, 0, 6, 20
"c:\Users\class\Cyclone\src\org\nuim\cyclone\model\value\StringValue.java", "Java", 14, 0, 0, 6, 20
"c:\Users\class\Cyclone\src\org\nuim\cyclone\model\value\Value.java", "Java", 14, 0, 4, 2, 20
"c:\Users\class\Cyclone\src\org\nuim\cyclone\parser\BaseParser.java", "Java", 42, 0, 11, 14, 67
"c:\Users\class\Cyclone\src\org\nuim\cyclone\parser\ParseErrorHandler.java", "Java", 28, 0, 12, 10, 50
"c:\Users\class\Cyclone\src\org\nuim\cyclone\parser\ParserHelper.java", "Java", 82, 0, 5, 12, 99
"c:\Users\class\Cyclone\src\org\nuim\cyclone\parser\StateMachine.g", "ANTLR", 0, 1029, 26, 61, 1116
"c:\Users\class\Cyclone\src\org\nuim\cyclone\parser\StateMachineLexer.java", "Java", 9938, 0, 1192, 1268, 12398
"c:\Users\class\Cyclone\src\org\nuim\cyclone\parser\StateMachineParser.java", "Java", 1872, 0, 251, 746, 2869
"c:\Users\class\Cyclone\src\org\nuim\cyclone\parser\ast\ASTBinaryExpression.java", "Java", 26, 0, 0, 6, 32
"c:\Users\class\Cyclone\src\org\nuim\cyclone\parser\ast\ASTConditionalOrExpression.java", "Java", 10, 0, 0, 3, 13
"c:\Users\class\Cyclone\src\org\nuim\cyclone\parser\ast\ASTContext.java", "Java", 61, 0, 3, 15, 79
"c:\Users\class\Cyclone\src\org\nuim\cyclone\parser\ast\ASTExpression.java", "Java", 17, 0, 0, 5, 22
"c:\Users\class\Cyclone\src\org\nuim\cyclone\parser\ast\ASTIdentifier.java", "Java", 42, 0, 2, 7, 51
"c:\Users\class\Cyclone\src\org\nuim\cyclone\parser\ast\ASTInvariant.java", "Java", 3, 0, 0, 2, 5
"c:\Users\class\Cyclone\src\org\nuim\cyclone\parser\ast\ASTLiteral.java", "Java", 51, 0, 0, 15, 66
"c:\Users\class\Cyclone\src\org\nuim\cyclone\parser\ast\ASTMachine.java", "Java", 53, 0, 6, 12, 71
"c:\Users\class\Cyclone\src\org\nuim\cyclone\parser\ast\ASTNode.java", "Java", 6, 0, 3, 2, 11
"c:\Users\class\Cyclone\src\org\nuim\cyclone\parser\ast\ASTState.java", "Java", 63, 0, 0, 18, 81
"c:\Users\class\Cyclone\src\org\nuim\cyclone\parser\ast\ASTStateModifier.java", "Java", 7, 0, 0, 1, 8
"c:\Users\class\Cyclone\src\org\nuim\cyclone\parser\ast\ASTTransition.java", "Java", 3, 0, 0, 2, 5
"c:\Users\class\Cyclone\src\org\nuim\cyclone\parser\ast\ASTUnaryExpression.java", "Java", 22, 0, 0, 8, 30
"c:\Users\class\Cyclone\src\org\nuim\cyclone\parser\ast\ASTVariable.java", "Java", 56, 0, 8, 8, 72
"c:\Users\class\Cyclone\src\org\nuim\cyclone\parser\ast\SemanticException.java", "Java", 26, 0, 4, 7, 37
"c:\Users\class\Cyclone\src\org\nuim\cyclone\parser\ast\SymTable.java", "Java", 26, 0, 0, 5, 31
"c:\Users\class\Cyclone\src\org\nuim\cyclone\parser\ast\SymTable64.java", "Java", 37, 0, 1, 9, 47
"c:\Users\class\Cyclone\src\org\nuim\cyclone\util\Color.java", "Java", 12, 0, 0, 2, 14
"c:\Users\class\Cyclone\src\org\nuim\cyclone\util\ColorPrint.java", "Java", 11, 0, 0, 5, 16
"c:\Users\class\Cyclone\src\org\nuim\cyclone\util\Entry.java", "Java", 23, 0, 0, 7, 30
"Total", "-", 14448, 1029, 1732, 2712, 19921